






F 222,100,0
C 225,30,0





NO textures/greystone.xpm
SO textures/purplestone.xpm
WE textures/redbrick.xpm
EA textures/eagle.xpm

dd
11111111111111111111
10000000000100000001
10000000000111100001
10E00000000000000001
10000000000100000001
10000000000100000001
10000000000100000001
10000000000100000001
10000000000100000001
11111111111111111111






