NO textures/redbrick.xpm
SO textures/colorstone.xpm
WE textures/greystone.xpm
EA textures/purplestone.xpm

F 184,113,200
C 11,108,227

111111111111
100000000001
100000000001
100000N00001
111111111111
